OOOOOOOOOOOOOOOOOOOOOOOOOOOOOOOOOOOOOOOOOOOOOOOOOOOOOOOOO
O     .OO           OOOOOOOOO                           O
OO  OO    O.O.OOOOO       OOO.OO.O.O.OOOOOOOOOOOOOOOOOO.O
OOO.OOOOOOO O OO  O O OOO OOO OO O O OOOOO            O O
O   OO    O O O   O O OO  OOO OO O O     O OOOOOOOOOO O O
O OO   OO O O O O O O OO O OO OO OOOOOOO O OOOOOOOOOO O O
O  O.OOO  O O O O   O OO . OO OO OO      O OO     O O O O
OO   O   OO O O O.OOO OOOO OO OO OO OOOO O OO OOO O O O O
OOOOOO.OOO  O O O O        OO OO OO OO O O OO.OOO O O O O
OOO      O.OOOOOO O OOOOOO.OO OO OO OO O O OO   O O O O O
OO  OOOO O     O  O         O OO OO OO O O O  O O O O O O
OO     O O OOO O OO OOOOOOO O OO OO OO O O O OO O OOO.O O
OOOOOO O O OOOOO OO.OO    O O OO  O OO O O O OO O     O O
O    O O O OO    OO    OOOO O OOOOO OO O O O OO OOOOOO  O
O O.OO O.O OO OOOOO OOOOO   . O O   OO O O O  O O  OOOOOO
O O    O   OO.O OOO OOOOOOOOO O O.OOOO.OOO.OO O OOO     O
O OOOOOOOOOOO    OO .      OO O.O          OO.O     OOO O
O             OO OO O OO O        OOOOOOOOO   OOOOOOOOO O
OOOOOOOOOOOOOOOOOOOOOOOOOOOOOOOOOOOOOOOOOOOOOOOOOOOOOOOUO

 